000000000000000000000000000000000000000000000000000000000000
000000000000000000000000000000000000000000000000000000000000
000000000000000000000000000000000000000000000000000000000000
000000000000000000000000000000000000000000000000000000000000
000000000000000000000000000000000000000000000000000000000000
000000000000000000000000000000000000000000000000000000000000
000000000000000000000000000000000000000000000000000000000000
000000000000000000000111111111000000011111111111000001110000
000000000000000000000000000000000000000000000000000000000000
000000000000000000000000000000000000000000000000000000000000
00111111111100000000000000000000000000000000011111110000000
000202222200000000000000000000000000000000000022222211110000
00000002200000000000000000000000000000000000000022022220000
000000000000000000000000000000000000000000000000000000000000
000000000000000000000000000000000000000000000000000000000000
111111111111111111111111111111111111111111111111111111111111
222222222222222222222222222222222222222222222222222222222222